################################################################################
#       #                               ##                                     #
#       #                               ##                                     #
#       #                               ##                                     #
#       #                               ##                                     #
#########                               ##                                     #
#                                       ##                  o                  #
#                                       ##                                     #
#                                       ##                                     #
#                                       ##                                     #
#                                                                              #
#                                                                              #
#                                                                              #
#                                                                              #
#               ####                       x                                   #
#               ####                                              ##############
#               ####                                              ##############
#               ####                                              ##############
#               ####                                              ##############
#               ####                                              ##############
#               ####                                              ##############
#               ####                                              ##############
#               ####                                              ##############
#               ####                                              ##############
################################################################################